#,#,#,#,#,#,#,#,#,#,#,#,#,#,#
#,L,L, ,G,B,G,T,B,G,G,B,S, ,#
#,G,#, ,#,#,#,#,#,#,#,#,#,#,#
#, ,#,G,#, ,#,G,B, , ,B, , ,#
#,B,#,T,#,T,#,G,#,#,#,#,#, ,#
#,B,#,L,#,G,#,G,B,B, , ,#, ,#
#, ,#, ,#, ,#,#,#,#,#,#,#,G,#
#, ,#, , ,G, ,G,B, , ,G, , ,#
#, ,#,#,#,#,#,#,#,#,#,#,#,#,#
#,G,#,T,B, ,B, , ,L, , ,G, ,#
#,B,#, ,#,#,#,#,#,#,#,#,#,G,#
#, , , ,T,B, , ,#, ,G, , , ,#
#,T,#,#,#, ,#,#,#,B,#,#,#,#,#
#, ,#, ,B, ,L,G,#,G,G,B,E, ,#
#,#,#,#,#,#,#,#,#,#,#,#,#,#,#
